H H H H H H H H H H H H 
S P _ _ H _ _ _ _ H K H 
H _ H H H H H H _ H _ H  
H _ _ D _ _ F H _ H _ H 
H _ _ H H H H H _ H _ H 
H _ _ _ _ _ _ _ _ _ _ H
H H H H H H H H H H H H 