H H H H H H H H H H H H H 
S P _ _ _ _ _ _ _ _ _ _ H 
H H H H H H H H H H _ _ H 
H _ _ _ _ _ _ _ _ _ _ _ H 
H _ H H H _ H H H H H _ H 
H _ _ _ _ _ _ _ _ _ _ _ H 
H _ H H H H H H H H _ _ H 
H _ _ H _ _ _ _ _ _ _ _ H 
H _ H H H H _ H H H H H H 
H _ _ K H _ _ _ D _ _ _ H 
H _ H H H H H H _ H H _ H 
H _ _ _ _ _ H _ _ F H _ H 
H H H H H H H H H H H H H 